####################
#P   #   #T  #    #
#    #   #   #    #
#    #T  #   #    #
####################
