█████████████████████████████████████
█                           █   █►$◀︎█
H           █               █ █ █►$◀︎█
█           █               █ █ █►$◀︎█
█           ████████        █ █ █► ◀︎█
█                           █ █ █► ◀︎█
█                           █ █ █► ◀︎█
█                             █    ◀︎█
████████████████████████████████   ◀︎█
█                                  ◀︎█
█ ♨︎        B                      ◀︎█
█                                 ◀︎█
█████████████████████████████████████
             █  ♨︎  █
             █ $$$ █ 
             ███ ███